111111111111111
1P001C000000001
100010001110001
100000001C00001
1C0000001E00001
111111111111111