111111111111111
1CCCCC10E100001
111110101111111
100010C00010001
101000010111001
1P1000011100001
111111111111111